
　　外企的招聘广告中常常有很多缩略语，让国人看起来头疼不已。下面是一些此类广告中常见的缩略语，帮助你看懂广告、“对职出招”。
　　admin: administrative 行政的
　　Jr: junior 初级
　　ad/adv: advertising 广告
　　K: 1000元
　　agcy: agency 经销商
　　knowl: knowledge 知识
　　appt: appointment 约会、预约
　　loc: location 位置、场所
　　asst: assistant 助理
　　Lv/lvl: level 级/层
　　attn: attention 给, 与……联系
　　mach: machine 机器
　　bkgd: background 背景
　　manuf/mf: manufacturing 制造
　　bldg: building 建筑物、大楼
　　mech: mechanic 机械的
　　bus: business 商业、生意
　　mgr: manager 经理
　　clk: clerk (办公室)职员
　　m-f: Monday-Friday 从周一到周五
　　co: company 公司
　　mth: month 月
　　coll: college 大专(学历)
　　nec: necessary 必要的
　　comm: commission 佣金
　　oppty: opportunity 机会
　　corp: cororation (有限)公司
　　ot: overtime 超时
　　data pro: data processing 数据处理
　　perm: permanent 永久性的
　　dept: department 部
　　pls: please 请
　　dir: director 董事
　　pos: position 职位
　　div: division 分工、部门
　　pref: preference (有经验者)优先
　　eqpt: equipment 装备
　　prev: previous 有先前的(经验)
　　etc.: and so on 等等
　　P/T: part time 兼职（的）
　　evngs: evenings 晚上
　　refs: references 推荐信
　　exc: excellent 很好的
　　rel: reliable 可靠的
　　exp: experience 经验
　　reps: Representative (销售)代表
　　exp'd: experienced 有经验的
　　req: required 需要
　　ext.: extension 延伸、扩展
　　sal: salary 工资
　　fr. ben: fringe benefits 额外福利
　　sctry: secretary 秘书
　　F/T: full time 全日制
　　sh: shorthand 人手不足
　　gd: good 好
　　sr: senior 资深
　　grad: graduate 毕业
　　stdnt: student 学生
　　hosp: hospital 医院
　　stmts: statements 报告
　　hdqtrs : headquarters 总部
　　tech: technical 技术上
　　hr hour: 小时
　　tel/ph: telphone 电话
　　hrly: hourly 每小时
　　temp: temporarily 临时性(工作)
　　HS: high school 高中(学历)
　　Trans: transportation 交通
　　Immed: immediate 立即
　　trnee: trainee 实习生
　　incl: including 包括
　　typ: typing/typist 打字/打字员
　　ind: industrial 工业的
　　wk: week/work 周/工作
　　inexp: inexperienced 无经验的
　　Wpm: words per minute 打字/每分钟
　　int'l: international 国际性的
　　yr(s): Year(s) 年
　　（来源：英语点津）